产科	Obstetrics
鲜肉水产	Meat, Poultry & Seafood
口腔正畸科	Orthodontics
三轮车接待站	Tricycle Tour
冰箱	Refrigerator
预检筛查室	Pretest & Screening Lab
语言文字	Languages
黄金三角区	Golden Delta
停车场收费处	Parking Booth
货物受理处	Cargo Service
采供血机构	Blood Collection & Supply Services
观众通道	Spectator Passage
标识牌	Signboard
香皂	Soap
体外治疗室	Extracorporeal Therapy
运动区域	Sports Zone
瀑布	Waterfall
温泉浴	Hot Spring Bath
母婴等候室	Mother and Child Waiting Room
西餐厅	Western Restaurant
眼超声检查室	Ultrasonography
第三人	Third Party
失物招领	Lost & Found
绝经相关疾病分诊治疗室	Post Menopausal Diseases Reception & Treatment
旅客止步	Staff Only
本航班往……	This Cruise Is Bound for…
温馨提示	Kind Reminder
上午十点	10:00 AM/am
卫生巾	Sanitary Pads
1	号泊位 Berth No.1
温室采摘	Greenhouse Fruit Picking
心脏加强病房	Cardiac ICU
咖啡馆/咖啡厅	Café
送风机房	Air Ventilation Room
院感科	Hospital Infection-Control
禁止抛物	No Littering
文明观赛	不喝倒彩 Please Have Good Manners When Watching Games
智慧导览	Smart Guide
应急疏散通道/紧急通道	Emergency Exit
儿科日间病房	Pediatric Day Ward
地下停车场收费处	Basement Parking Fare Collection
综合业务厅	Comprehensive Services Hall
胃肠电图室	Electrogastrogram (EGG)
注意有电	Warning: Electrical Shock!
鲜奶	Milk
蜂蜜	Honey
夜间	Night
互联网创新集聚区	Internet Innovation Cluster Area
窗沿禁止放置物品	Please Do Not Leave Things on Windowsill
肝移植诊室	Liver Transplant Consultation
军事	Military Science
足金精品	24K Gold Gifts
瓷器	Porcelain
a	型血液告急 Group A Blood Donors Needed
b	超 B-Scan Ultrasound
癫痫门诊	Epilepsy Clinic
排行榜	Rankings
裁判员室	Referees Room
宿舍楼	Dormitory
爱国主义教育基地	Base for Raising Patriotism Awareness
广东省汽车客运站	Guangdong Provincial Intercity Bus Terminal
甲型肝炎门诊	Hepatitis A Clinic
o	型血液告急 Group O Blood Donors Needed
the	Forest, Handle Fire Emergencies According to Law
腹部超声室	Abdominal Ultrasonography
导管室	Catheter
x	线诊断室 X-Ray Diagnosis
儿科	Pediatrics
招商中心	Business Promotion/Office Rental Center
货梯	Cargo Lift
广东财政厅旧址	Former Site of Department of Finance of Guangdong Province
消毒柜	Kitchen Sterilizer
中式快餐	Chinese Fast Food
献血办公室	Blood Donation Clinic
保健门诊	Healthcare Clinic
综合内科	General Medicine
羊绒	Cashmere
皮具	Leatherware
机场巴士	Shuttle Bus
幽谷二段	Valley Segment II
法规督察科	Regulatory Supervision Section
手机充电处	Cell Phone Recharge
现场抢救组	First Aid Team
儿童保健科/儿童保健管理科	Child Healthcare
书房	Study Room
玉兰大道	Magnolia Avenue
城郊购物中心	Suburban Shopping Center
精神科	Psychiatry
美容美发中心（厅）/美容沙龙	Beauty Salon
曲奇	Cookies
国际金融中心	International Finance Center
千足金耳钉	99.9% Gold Ear Studs
门诊楼	Outpatient Building
友好亭	Friendship Pavilion
散场通道	EXIT
超声心动图室	Echocardiogram
神经遗传病门诊	Neurogenetics Clinic
第七仲裁庭	The 7th Court of Arbitration
揽胜探险	Expedition
遗传诊断中心	Genetic Diagnosis Center
经理办公室	Manager
女诊室	Female Consultation Room
幽谷三段	Valley Segment III
走失儿童认领	Lost Child Claim
无购物通道	Exit Without Purchase
图像分析室	Image Analysis
助听器验配室	Hearing Aid Fitting Center
驾驶室	Bridge
人事处/科	Human Resources
献血前等候区	Donors Waiting Area
滑动开门	Slide to Open
电影院	Cinema
多媒体	Multimedia
感染科	Infection /Communicable Diseases
博物馆活动	Museum Activities
绿道（麓湖路至双燕岗路）	Green Trail (from Luhu Road to Shuangyangang Road)
空调	Air Conditioner
检查口	Inspection Gate
客房部	Housekeeping Department
阴道镜室	Vaginoscopy
土特产展销广场	Gift & Specialty Square
剧院	Theatre
一/二/三/四/五层（楼）	F1/F2/F3/F4/F5
药流分诊	Drug-Induced Abortion Reception
非旅游通道	禁止通行 Non-tourist Passageway! No Entry!
北楼平面导览图	North Tower Floor Plan
口腔急诊科	Emergency
船员休息室	Crew’s Room
请看管好您的随身物品	Please Keep Your Belongings Attended
报刊阅览室	Newspapers & Periodicals Reading Room
烟	Cigarette
艾滋病咨询门诊	HIV/AIDS Counseling Clinic
监督电话：81939400	Supervision Hotline: 81939400
后区	Back Section
口腔硬组织检查室	Hard Tissue Examination
行车道	Car Lane
主动音乐治疗室	Active Music Therapy
集装箱堆场	Container Yard
消化内科	GI Medicine
客梯/电梯	Elevator/Lift
妇女病防治科	Women’s Disease Prevention and Treatment
见证服务管理部	Witness Service Management
心理科	Psychology
声像室	Audio-Video
二级文物	Class Two Cultural Heritage
广州市工人文化宫	Guangzhou Workers’ Cultural Palace
皮肤病科	Dermatology
三楼定额	人 Passenger Capacity on F3: xxx
紧急呼救设施/紧急报警器	Emergency Alarm
脊柱门诊	Spine Clinic
超市	Supermarket
外宾团体观众	Foreign Group Visitors
旅客出站口	Passenger Exit
评标专家管理部	Bidding Expert Management
广州市新图书馆	Guangzhou New Library
观众入场	Audience Entrance
佛山市体育馆	Foshan Gymnasium
消防器材	Fire Equipment
旅游	X 号线站台通道 Passage for Tour Bus X
内分泌病门诊	Endocrinology Clinic
二楼单号侧区	Balcony Odd Numbers
干燥室	Desiccation
牙周粘膜科	Periodontics & Oral Medicine
妇科	Gynecology
骨科烧伤	Orthopaedics & Burn
肠道病门诊	Enteric Diseases Clinic
留学	Overseas Study
生物	Biology
历史	History
外科特级专家门诊	Senior Specialist Clinic
步行梯/楼梯	Stairs
眼底照相室	Fundus Photography
贵宾区	VIP
缆车	Cable Car
休闲娱乐	Recreation & Entertainment
皮埋门诊	Subepidermal Contraceptive Implant Clinic
中医候诊室	TCM Waiting Room
室内导航服务系统	Indoor Navigation Service System
检斤处	Baggage Weighing
钻石精品	Exquisite Diamond Works
观众席	Audience Seats
绿道	Green Trail
免疫预防门诊	Vaccination & Immunoprophylaxis Clinic
口腔清洁用品	Dental Care Products
景观	Scenery
科技馆	Science & Technology Museum
中医专家门诊	TCM Specialist Clinic
客运站	Intercity Bus Terminal
邮局	Post Office
婴幼儿营养保健中心	Infant Nutrition & Healthcare Center
汽车专项维修业户	Motor Vehicle Maintenance & Specialty Repair Services
留言板	Message Board
酒	Alcohol/Liquor
摆药室	Drug Dispensing
手稿	Manuscripts
儿科急诊药房	Pediatric Emergency Pharmacy/Dispensary
码头	Wharf
请家长带好您的小孩	Please Take Care of Your Children
贵宾厅	VIP Lounge/Hall
肌兴奋治疗室	Muscle Stimulating Treatment
无抽诊室	Non-convulsive Consultation
婴儿浴室	Infant Bath
儿童金饰品	Gold Accessories for Children
协议采购部	Contract Procurement
的士之星	Taxi Star
紧急医疗救援中心	Emergency Medical Rescue Center
千足金耳环	99.9% Gold Earrings
纪检监察室	Disciplinary Oversight
天文	Astronomy
紧急逃生工具/仅供紧急情况下使用	Emergency Use Only
垃圾不落地，景区更美丽	Please Do Not Litter and Keep Scenic Area Beautiful
洗涤间	Laundry Room
手工艺展示	Handicraft Display
幽谷一段	Valley Segment I
模型	Model
展区	Exhibition Area/Display Area
古人类化石	Palaeoanthropology Collection
售票处停车场	Parking Area of Ticket Office
高等教育	Higher Education
消防通道，禁止停车	Fire Engine Access. No Parking.
耳鼻喉科专家门诊	ENT Specialist Clinic
胸透室	Chest X-Ray
医护办公室	Staff Office
广州塔	Canton Tower
投资理财	Investment & Financing
周围血管超声室	Peripheral Vascular Ultrasonography
综合货运站	Comprehensive Cargo Services
检票口	Ticket Check
内分泌治疗中心营养测定室	Endocrinotherapy Center Nutrition Testing
药浴室	Medicated Bathroom
第一手术室	Operating Room 1
保险条款	Clauses of Insurance
社会车辆入口	Public Vehicles Entrance
皮革毛草/皮革皮草	Leatherwear & Furs
区域集中供冷系统	Centralized District Air Conditioning System
餐具清洁间	Dining Utensils Cleaning
亲友等候区	Waiting Area
歌厅	KTV/Karaoke
中药调剂室	TCM Dispensing
剧场	Theater
男士休闲装	Men’s Casual Wear
美食天地	Food Court
现代书画	Contemporary Paintings & Calligraphy
野营露营	Camping
国家级文物保护单位	National Cultural Heritage Site
卫生监督机构	Health Inspection Authorities
枢纽西北大厅	Bus Hub Northwest Hall
快速通道	Express Lane
残疾人（无障碍）观众席	Accessible Seating
急诊创伤诊室	A&E Trauma Consultation
航线	Route
供应保障区	Supply Area
二楼旅客入口	F2 Passenger Entrance
高速路/高速公路	Expressway (Expwy)
小说	Fiction
值班岗亭	Security Booth
图书查询台	Inquiry
遗址	Historic Site
奶粉	Baby Formula/Powered Milk
脑血管病门诊	Cerebrovascular Diseases Clinic
职业病咨询门诊	Occupational Disease Counseling Clinic
展厅	Exhibition Hall
危险，请勿进	Danger! Do Not Enter
健身器材	Fitness Equipment
水果	Fruits
中医科按摩室	TCM Massage
商务印书馆广州分馆旧址	Former Site of the Commercial Press Guangzhou Branch
清洁消毒室	Cleaning & Disinfection
地下停车场入口	Basement Parking Entrance
心律失常门诊	Arrhythmia Clinic
火警下压器	Fire Alarm Press Down (↓)
妇科泌尿学	Gynecological Urology
本部急救分中心	Headquarters First Aid Branch
室外消防栓	Outdoor Fire Hydrant
严禁吸烟	No Smoking
其他垃圾	Other Waste
严禁易燃易爆危险品登船	Inflammable, Explosive & Dangerous Goods Prohibited
候船入口	Entrance
职业女装	Women’s Suit
青春服饰	Clothing & Accessories for the Young
导览机	Audio Guide
金银珠宝/珠宝	Gold, Silver & Jewelry/Jewelry
培训室	Training Room
能源与环境	Energy & Environment
巡回展览	Touring Exhibition
进口/原版引进	Imported
营养门诊	Nutrition Clinic
投诉接待处	Complaints
头痛门诊	Headache Clinic
乐器	Musical Instruments
当心触电	220V Danger! High Voltage! 220V!
医馆室	Medical Officer’s Quarters
无障碍售票口	Wheelchair Accessible
碧波楼	Green Wave Pavilion
审批办证科	Review of Application for Approval & License
生活饮用水	Drinking Water
桃花岛	Peach Flower Island
商店	Shop
物资采购供应中心	Materials Purchase & Supply Center
乘坐出租车温馨提示	Notice on Taxi Service
男更衣室	Men’s Locker Room
前站	qian Station
保险	Insurance
游戏厅	Game Center
租赁流程	Rental Procedure
购物车	Shopping Trolley
牙体牙髓科	Endodontics
临床药理基地办公室	Clinical Pharmacological Center Office
宫、院	Palace
起点	Starting Point
戏剧	Drama & Theatre
老年活动中心	Senior Activity Center
机舱	Engine Room
大佛寺	Great Buddha Temple
献血后关爱（短信平台）	Post Blood Donation Care (Message Platform)
复制品	Replica
社区卫生服务中心	Community Public Health Service Center
白天	Day
神经内科急诊	Emergency Neurology
水疗生活馆	Spa
体液常规化验室	Routine Test Lab for Body Fluid
全日（昼夜）停车场	24-Hour Parking
电影拍摄	Filming
机房	Machinery Control Room
货物提取	Cargo Claim
无障碍卫生间	Accessible Toilets/Wheelchair Accessible
去离子设备间	Deionization Equipment
空港经济区	Aerotropolis Development District
公告栏	Notice Board
倾斜试验检查室	Inclination Experiment
保暖内衣	Thermal Underwear
输血科	Blood Transfusion
维修班	Maintenance
成人外借部	Book Borrowing for Adults
接待员	Receptionist
中餐厅	Chinese Restaurant
中医科针灸科	TCM Acupuncture
自助行李寄存	Self-service Lockers
生活饮用水卫生监督	Clean Water Oversight
布鞋拖鞋	Fabric Shoes & Slippers
停车锁车器	Parking Lock
性医学门诊	STD Clinic
体育场	Stadium
语言治疗室	Speech Therapy
软路肩	Soft Shoulder
餐馆	Restaurant
网球场（1-5）	Tennis Court No.1–5
产后康复中心	Postpartum Recovery Center
南站	South Railway Station
运动医学科专家门诊	Sports Medicine Specialist Clinic
发热筛查室	Fever Screening Clinic
客运主枢纽	Public Transport Hub
执法监督一科	Law Enforcement & Supervision Section 1
电脑	Computer Science
政府采购审核部	Government Procurement Review
观众入场门（单号）	Audience Entrance (Odd Numbers)
木制文物	Wooden Culture Heritage
二楼乘车区	F2 Boarding Area
区（县）卫生局卫生监督所	District (County) Health Inspection Institute
专业项目交易部	Specialized Project Trading
医护部	Medical & Nursing
二楼售票厅	F2 Ticket Office
平衡障碍室	Balance Disorder Treatment
素质教育	Character Building Education
外科专家门诊	Specialist Clinic
成人教育/继续教育	Adult Education/Continuing Education
票价	Fare
游乐场	Playground
药剂科	Pharmacy
妇产科	Obstetrics & Gynecology
渔业	Fishery
危险勿动	Danger! Do Not Touch
年鉴	Yearbooks
涎腺疾病中心	Salivary Gland Diseases Center
中药代煎室	TCM Decoction
机舱盖上	严禁坐立 Do Not Sit or Stand on Engine Room Hatch
肠道传染病化验室	Infectious Enteric Diseases Lab
毛织/羊毛服装	Wool & Knitwear
钟表眼镜	Clocks, Watches & Glasses
深水区	Deep Water
特色食品	Local Foods
红宝石饰品	Ruby Accessories
危险物品	Hazardous Articles
母婴保健中心	Maternal and Infant Healthcare Center
外科治疗室/外科处置室	Surgery Treatment
监控室	Monitoring
钻石戒指	Diamond Ring
中药房	TCM Pharmacy/TCM Dispensary
淡季开放时间	Opening Hours in Slack Seasons
抬	Lift
行李寄存/物品寄存	Baggage Deposit
大件垃圾	Bulky Waste
理疗室	Physical Therapy
新书推荐	New Arrivals
出租车待客区	Taxi Stand
动脉弹性室	Arterial Elasticity Determination
休闲食品	Snacks
盖章处	Stamp Service
开馆时间	Opening Hours
颞颂关节疾病诊疗中心	TMJ (Temporomandibular Joints) Center
hbv	携带者诊室 HBV Carrier Consultation
新生儿隔离门诊	Newborn Isolation Clinic
皮肤科治疗室	Dermatology Treatment
口腔预防科	Preventive Dentistry
针棉织品	Knitted Cotton Goods
新闻办公室	Media Office
病案科	Medical Records
住院区/病区	Inpatient Area
信息管理部	Information Management
自然保护区	Nature Reserve
项目办公室	Project Office
工程部办公室	Engineering Office
数字减影	Digital Subtraction (DSA)
车辆管理科	Vehicle Management
高压氧科	Hyperbaric Oxygen (HBO)
骨密度（测量/检查）室	Bone Density (Test/Examination)
盥洗室	Toilets
财务管理部	Finance
地理	Geography
进口高档化妆品	Imported Cosmetics
内科普通门诊	Internal Medicine Regular Clinic
小儿骨科专家门诊	Pediatric Orthopaedic Specialist Clinic
放射治疗科	Radiotherapy
十二生辰石	Chinese Zodiac Stones
白云山滑索上站	Upper Station of Baiyunshan Zipline
儿童性发育门诊	Child Sexual Development Clinic
检验科/临床检验室	Clinical Lab
门诊	Outpatients
西区急救分中心	West District First Aid Branch
自助售取票区	Automatic Ticket Service
康复门诊	Rehabilitation Clinic
录像资料	Video-Recordings
街旁游园	Community Park
石膏室	Plaster
电影剪辑	Film Editing
（私人）内部停车场	Private Parking
禁止坐卧	No Sitting or Lying
远程医学会诊中心	Remote Medical Consultation Center
肝炎一科	Hepatitis Dept.1
洁净室	Clean Room
展品	Exhibit
磁共振室	Magnetic Resonance (MR) /MRI
长途汽车站	Intercity Bus Terminal
白云山滑索下站	Lower Station of Baiyunshan Zipline
北区	North Zone
公园	Park
祝您旅途愉快	Have a Nice Trip
南越王宫博物馆	Archaeological Site Museum of Nanyue Palace
文物鉴定	Cultural Heritage Authentications
家长请带好小孩	Please Take Care of Your Children
休息日	Closed
北京路步行街	Pedestrian Section of Beijing Lu
代办邮寄	Mailing Service
手机服务营业厅	Cellphone Service Hall
爱护花草，请勿采摘	Do Not Pick Flowers
血液病门诊	Hematology Clinic
水疸门诊	Chicken Pox Clinic
观赏区	Viewing Area
普通透视室	Fluoroscopy
汽修	Auto Service
百科	Encyclopedias
数字胃肠造影室	Digital GI Examination
当心滑跌	CAUTION! Slippery Surface
骨组阅片室	Skeletal Radiology
围产保健室	Perinatal Healthcare
首席仲裁员	Presiding Arbitrator
金融证券	Finance & Securities
乳腺门诊	Breast Clinic
游乐场/游乐园	Amusement Park
值星副官室	On-Duty Lieutenant’s Room
收费处	Pay Here
办公区	Administration Office
食品部	Snack Bar
输液观察室	Transfusion Observation
行驶中请勿站立	Please Stay Seated While Bus Is Moving
字画店	Calligraphy & Painting Store
停车收费标准/停车费	Parking Rates
急救中心	First Aid Center
小儿心脏科	Pediatric Cardiology
老年艺术治疗厅	Geriatric Art Therapy
泌尿外科膀胱镜室	Urology Cystoscopy
观众入场门（双号）	Audience Entrance (Even Numbers)
麻醉恢复室	Anesthesia Recovery Room
免疫组化室	Immune-Histochemical Lab
网球场	Tennis Court
门诊化验室	Laboratory/Lab
妇科微创中心	Minimally Invasive Gynecology Center
励志	Self-improvement
干鲜蔬菜	Dried and Fresh Vegetables
急诊科	Emergency
中医皮肤门诊	TCM Dermatology Clinic
行包托运处	Baggage Check
骨质疏松门诊	Osteoporosis Clinic
户外运动系列	Outdoor Sports Series
图书收购	Used Books Wanted
执法监督二科	Law Enforcement & Supervision Section 2
公园牌坊	Paifang
中医儿科	TCM Pediatrics
外科	Surgery
成人票价	Adult Price
生物反馈诊疗室	Biofeedback Consultation
家居建材商店	Home Décor & Furnishing Store
产科超声波诊断室	Obstetric Ultrasonography
随访门诊	Follow-up Clinic
内窥镜室/内腔镜室	Endoscopy
耳鼻喉科门诊治疗室	ENT Treatment
仲裁办公室	Arbitration Office
咖啡	Coffee
落花未必有意	摘花一定无情 No Picking of Flowers
化妆间	Dressing Room
出租汽车上下/停靠站	Taxi Stand
排	Row
竞赛办公室	Competition Office
场地区	Performance Area
拱桥	Arch Bridge
地铁	Metro
足金项坠	24K Gold Pendant
手机配件	Cellphone Accessories
书画	Painting & Calligraphy
厨房	Kitchen
摄影	Photo Taking
干菜	Dried Vegetables
不得随地大小便，便后请及时冲洗。	Flush after use.
心肺功能科	Cardio-Pulmonary Function
贵宾休息室/贵宾厅	VIP Lounge
信息服务	Information Counter
电房	Power Distribution Room
检测报告发放处	Test Report Desk
妇科分诊	Gynecology Reception
自画像	Self-portrait
物业行政部	Property Maintenance
值班经理台	Manager on Duty
中西医结合科	Integrated TCM & Western Medicine Dept.
北台	North Platform
饮用水	Drinking Water
影城出口/散场出口/散场通道	EXIT
小件寄存/衣帽寄存/代客存衣	Baggage Deposit
医用电梯	Medical Service Elevator
元/半小时	RMB/Half-Hour
脊柱病房	Spine Ward
门卫室	Security Room
残疾人设施	For People with Disabilities
男性科	Andriatrics
小件寄存处	Baggage Deposit
观光梯	Sightseeing Elevator
禁止骑车下浮桥	No Cycling
步行登山道	Hiking Trail
南粤交投驻场办	Office of Nanyue Transportation Investment and Construction
第一仲裁庭	The 1st Court of Arbitration
紧急出口	Emergency Exit
请勿触摸	Do Not Touch
心脏病门诊	Cardiology Clinic
娱疗厅	Recreational Therapy
性病咨询门诊	STD Counseling Clinic
电视机	Television
艺术	Art
女士休闲采购部	Women’s Casual Wear Purchase
检验科（血液筛查实验室）	Blood Screening & Test
罐头	Canned Food
牙片室	Dental Film
车辆通道/车道	Vehicle Lane
玉器	Jadeware
女士精品采购部	Women’s Choice Goods Purchase
临床检验实验室	Clinical Test Lab
儿童生长发育科	Child Growth & Development
上楼楼梯	Upstairs
数学	Mathematics
洗护发用品	Shampoo & Conditioner
货物托运	Freight Transport
自助服务机	Self Service
中学教育	Secondary School Education
寝具毛线	Bedding & Woolens
楼上	Upstairs
硬件	Hardware
游船码头	Pier
地上一层/二层	F1/F2
口腔手术室	Oral Operating Room
展室/陈列室	Exhibition Room/Display Room
配液室	Liquor Room
内科专家门诊	Internal Medicine Specialist Clinic
大桥	Bridge
亚运公园	Asian Games Park
残疾人专用通道	Wheelchair Accessible
免疫规范化门诊	Standardized Vaccination Clinic
肾病科	Nephrology
儿童摄影室	Children Photograph Studio
职工食堂	Staff Dining
信息统计	Information Statistics
医院感染控制与消毒科	Hospital Infection Control & Disinfection
南出口（x）	South Exit X
蔬菜	Vegetables
大客车专用入口	Coach Entrance
证人席	Witness Stand
残疾人	Disabled
放射科片库	Radiology Storage
会员卡充值处	Membership Card Recharging
急诊输液室	A&E Transfusion
社区购物中心	Community Shopping Center
珍珠饰品	Pearl Accessories
心肌病门诊	Cardiomyology Clinic
曰用百货	Household Items
外币兑换处	Foreign Exchange
洗片室	Developing Room
军事博物馆	Military Museum of the Chinese People’s Revolution
照相器材采购部	Camera Equipment Purchase
触摸区	You may touch animals here
隔离取血室	Isolated Blood Drawing
中医正骨科	TCM Bone-Setting
商场楼层平面图	Shopping Mall Floor Plan
团体接待	Group Reception
通行区/场馆公众区	FOH (Front of House)
结核内科	Tuberculosis
工作重地，游客止步	Staff Only
小型车专用入口	Car Entrance
考古	Archaeology
准驾证号	Driving Permit No.
神经外科门诊	Neurosurgery Clinic
折扣店	Outlets
国家	A 级景区 Class (A) National Scenic Spot
熟食糕点	Cooked Food & Bakery
新生儿抚触室	Newborn Massage Center
集装箱中转站	Container Transfer Station
休息厅/休息处/顾客休息室	Lounge
献血纪念品、献血证发放处	Souvenirs & Donation Certificate Distribution
生殖调节科	Reproductive Regulation
垂钓用具	Fishing Equipment
饼干	Biscuits
雨具租用处	Umbrella Rental
古脊椎动物化石	Vertebrate Paleontology Collection
旅游信息咨询中心	Tourist Information Centre
休息处	Rest Area
行政办公室	Administration
女士皮鞋	Women’s Leather Shoes
平板运动试验检查室	Treadmill Testing (TMT)
登山道	Path
学术类	Academic Books
妇科观察室	Gynecology Observation
日光浴	Sunbathing
献血体检	Donors Physical Examination
中成药房	Chinese Prepared Medicine Pharmacy/Chinese Prepared Medicine Dispensary
宠物乐园	Pet Playland
骨科诊室/骨科门诊	Orthopaedic Consultation Room/Orthopaedic
乳腺科	Galactophore
文印室	Copy & Photocopy Room
血尿门诊	Hematuria Clinic
肾移植科	Kidney Transplant
灭火器/灭火器箱	Fire Extinguisher
第四仲裁庭	The 4th Court of Arbitration
婴儿治疗室	Infant Therapy
物流中心	Logistics Center
美术馆/艺术馆	Art Museum
非工作人员请勿入内	Staff Only
安全乘船指引	Safety On Board Guide
杂志编辑部	Journal Editorial Office
公共场所卫生监督	Sanitation Oversight of Public Facilities
作业治疗室	Occupational Therapy
报告厅	Conference Hall/Auditorium
救生衣演示	Life Jacket Demo
陶艺治疗室	Pottery Therapy
体育馆	Gymnasium
图书销售排行榜	Book Sales Ranking
观众入口	Audience Entrance
花草有生命	请勿采摘 Please Do Not Pick Flowers
数码产品	Digital Products
城隍庙	City God Temple
食品卫生监督	Food Hygiene Supervision
自行车通道	Bike Lane
童鞋/儿童鞋	Children’s Footwear
呼吸门诊	Respiratory Clinic
学雷锋志愿者服务站	Volunteer Service Station
足金戒指	24K Gold Ring
小心有电	Electrical Shock
文物库房	Cultural Heritage Storage
历史文化展览	History and Culture Exhibition
教育类	Education
音乐	Music
日用品	Daily Necessities
吸烟室、吸烟区	Smoking Room/Smoking Area
儿童常见病防治科	Common Pediatric Disease Prevention & Treatment
书院	Academy
预计里程（公里）	Estimated Distance (km)
心理治疗室	Psychotherapy
肿瘤内科	Oncology
哲学	Philosophy
内科处置室/内科治疗室	Internal Medicine Treatment
金属	Metal
呼吸道传染病诊室	Infectious Respiratory Diseases Consultation
检票处	Ticket Check
应急安置区	Emergency Assembly Point
厨卫	Kitchen & Bathroom
备注	Note
动物	Zoology
运动服装/体育服装	Sportswear
纸类	Paper
评标区	Tender Evaluation Area
地方病控制所	Institute of Endemic Diseases Control
听力室	Audiometry
带状公园	Belt Park
动漫图书	Cartoons & Comics
布艺	Fabrics & Lace
肿瘤科	Oncology
派出所	Police Station
“府学双泉”古井	Ancient Double-spring Well
古籍	Classics
快速检测车	Quick Test Vehicle
火车东站	East Railway Station
安检处	Security Checkpoint
样品室	Sample
公共关系科	Public Relations
研究	Research
桥（大桥）	Bridge
第六仲裁庭	The 6th Court of Arbitration
元/小时	RMB/Hour
医疗卫生监督科	Medical Oversight Section
男配饰	Men’s Accessories
普通取血室	Ordinary Blood Drawing
公交中心站	Central Bus Station
婚纱影楼	Wedding Photograph Gallery
男厕所	Gents/Men
中医多动症门诊	TCM Minimal Brain Dysfunction (MBD) Clinic
中医理疗科	TCM Physiotherapy
滑草道	Mountain Zipline
湖内水深	严禁游泳 Deep Water! No Swimming!
人类	Anthropology
眼科门诊缝合室	Outpatient Suture
社会服务部	Social Service Dept.
干部医疗科	Medical Treatment for Officials
社区卫生服务站	Community Public Health Service Station
病房	Ward
金属制品	Metalware
电脑及配套设备	Computers & Accessories
脊柱专家门诊	Spine Specialist Clinic
导游亭	Tour Guide Booth
便民挂物架	Public Hanger
游客停车场布局示意图	Tourist Parking Lots
新闻发布厅	Press Conference Hall
洗车	Car Wash
市区购物中心	Downtown Shopping Center
本月排行	Monthly Best Sellers
儿科抢救室	Pediatric Rescue
行李车	Baggage Trolley
摄影培训室	Photography Learning
设备重地	Equipment Room
血管造影室	Angiography
自行车架	Bicycle Stand
碑记	Tablet Inscription
欢迎您再来	Hope to see you again!
宫腔镜室	Hysteroscopy
无障碍设施	Wheelchair Accessible
内分泌科	Endocrinology
数字见证室	Digital Witness Room
舞厅	Dance Hall
综合药房	Integrated Pharmacy/Integrated Dispensary
取检查、检验结果处	Test Reports
世界文化遗产	World Cultural Heritage
螺旋	CT 扫描室 Spiral CT Scan
小儿骨科急诊	Emergency Pediatric Orthopaedic
学好英语走向世界	Gain a Good Command of English, Embrace the World!
力量训练房	Strength Training Gymnasium
复原陈列	Restored Exhibits
特色旅游购物街区	Tourist Shopping Street
新青年社旧址	Former Site of New Youths Press
1-23	检票口 Checkin Counter No.1–23
钻石项链	Diamond Necklace
茶园站点	Tea Garden Station
老年诊室	Geriatric Clinic
运动医学病房	Sports Medicine Ward
摄影器材	Camera Equipment
办公区域/办公区	Office Area
字典/辞典	Dictionaries
地质年代	Geologic Age
临时停车	Temporary Parking
供应室	Supply Room
铂金	Platinum
取精室/精液收集室	Semen Collection
采血室	Blood Sampling Room
后装治疗室	Afterloading Radiotherapy
小草青青，请勿践踏	Please Keep off Grass
妇儿科	Gynecology & Pediatrics
中华书局广州分局旧址	Former Site of China Publishing House Guangzhou Branch
始发站	Departure Station
营销	Marketing
治疗、换药室	Treatment & Dressing
经济技术开发区	Economic and Technological Development Zone
请勿携带宠物	No Pets Allowed
外科实验室	Surgery Lab
李占记钟表铺	Lee Jim Kee Clock & Watch Co., Ltd.
肝移植康复中心	Liver Transplant Rehabilitation Center
小心地滑	严禁跨越 Caution: Wet Floor! No Crossing!
家用电器/精品小家电	Household Electric Appliances
常规化验室	Routine Test Lab
电影衍生品专卖区	Movie Products Area
录入室	Data Entry
应急药箱	Emergency Medicine Cabinet
取药处/药房/西药房	Pharmacy/Dispensary
会计室	Accounting/Accountants
门诊办公室	Outpatient Office
药品划价/划价处	Prescription Pricing
消防应急面罩	Emergency Fire Mask
应急指挥车	Emergency Command Vehicle
外科无菌室	Surgery Sterile
展场	Exhibition Area
公交枢纽站	Public Transport Hub
中医眼科	TCM Ophthalmology
翠楼	Jade Pavilion
青铜器	Bronzeware
路侧停车	Roadside Parking
汇合点	Conjunction
学生票价	Student Price
健康教育室	Health Education
口腔综合科	General Dentistry
外语	Foreign Languages
往三楼甲板→	To F3 Deck
医务部（处）	Medical Administration
眼激光室	Eye Laser Therapy
接待标准	Service Standards
星海桥	Star Sea Bridge
广告	Advertising
翡翠饰品	Jade Accessories
纤维鼻咽喉镜检查室	ENF-GP Examination
电影洗印	Film Processing
运动医学科门诊	Sports Medicine Clinic
排练厅	Rehearsal Studio
桥站点	Bridge Station
兴奋剂检查室	Doping Check Room
组织人事部	HR
长洲码头	Changzhou Wharf
北门	North Gate
纪念馆	Memorial Museum
文化旅游区	Cultural Tourism Zone
自动控制	Auto-control
加工室	Processing Room
自行车库/自行车停放处	Bicycle Parking
展板	Display Board
钻石手链	Diamond Bracelet
地图	Map
脑电图室	EEG
洗衣工作间/洗衣店/洗衣房	Laundry
水上运动	Water Sports
就诊区	Outpatient Area
禁止触摸	No Touching
物流管理部	Logistics Management
后台示意图	Backstage Map
中医科	Traditional Chinese Medicine (TCM)/TCM
自行车停放处	Bicycle Parking
病理会诊	Pathology Consultation
零担货运站	LTL (Less-Than-Truckload) Cargo Services
痴呆门诊	Dementia Clinic
天河体育中心	Guangzhou Tianhe Sports Center Stadium
桥出口	Bridge Exit
内科病房	Internal Medicine Ward
请勿在浮排停留	Do Not Stay on Pontoon
女配饰/女士饰品	Women’s Accessories
肺功能室	Pulmonary Function Testing
门诊注射输液室	Injection & Transfusion
中医骨病治疗科	TCM Orthopaedics Treatment
强电竖井	Vertical Duct for High Voltage
演艺	Performance Art
女性尿失禁防治中心	Female Incontinence Prevention and Treatment Center
心脏超声室	Echocardiography
一级文物	Class One Cultural Heritage
擦鞋机	Electric Shoe Polisher
维修员	Maintenance Technician
中国画	Chinese Paintings
收费站	Toll Gate
纯水站	Purified Water Station
二楼定额	人 Passenger Capacity on F2: xxx
空气浴	Air Spa
广播	Broadcasting
库房	Storage Room
展架	Display Rack
图书馆	Library
普通外科门诊	General Surgery Clinic
大型车道	Oversize Vehicle Lane
dvd	专区 DVDs
租赁汽车须知/租用告之	Car Rental Notice
前廊	Front Aisle
公交站	Bus Station
驱铅门诊	Lead Removal Clinic
花木共赏	严禁采摘 Please Do Not Pick Flowers!
紧急呼救电话	Emergency SOS Phone
复建文物建筑	Restored Heritage Buildings
袜子	Socks
儿科预检室	Pediatric Pre-Examination
中庭	Middle Stall
手术恢复室	Postoperative Recovery Room
公共广播系统	Public Address System (PA System)
仲裁服务大厅	Arbitration Service Center
展柜	Showcase
彩弹野战	Paintball War Game
城市建设展览	Urban Development Exhibition
环节质控组	In-Process QC Group
健身中心	Fitness Center
应急物资储备室	Emergency Reserve
儿童纤维支气管内镜诊断治疗中心	Pediatric Bronchoscopy Center
医技楼	Medical Technology Building
发票联	Invoice
骨肿瘤门诊	Bone Tumor Clinic
宫颈疾病诊治中心	Cervical Diseases Diagnosis & Treatment Center
索引	Indexes
微量元素检测	Trace Elements Detection
网络通信	Network Communications
物流园区	Logistics Park
超声分诊室	Ultrasonography Reception
抑郁症诊室	Depression Clinic
自动充值机	Top up Machine
24	小时自助服务点 24-Hour Self Service
绿化整顿中	Planting in Progress
体采科	Physical Examination & Blood Collection
新闻	Journalism
标本登记处	Specimen Registration
工艺美术品	Arts & Crafts
副庭长室	Associate Chief Judge’s Office
坐厕	Sitting Toilets
pt950	戒指 PT950 Ring
番禺市桥汽车站	Panyu Shiqiao Bus Station
市级文物保护单位	Municipal Cultural Heritage Site
大客车专用出口	Coach Exit
体疗厅	Physical Therapy
书法培训室	Calligraphy Learning
被申请人	Respondent
病房楼	Inpatient Building
副院长办公室	Deputy President of Commission
百货	Supermarket
月牙湖站点	Crescent Moon Lake Station
电子阅览室	Digital Reading Room
营业厅	Service Hall
骨外科	Orthopaedic Surgery
干海产品	Dried Seafood
领带	Ties
地面交通系统图	Ground Traffic System Plan
特价图书	Discounted Books
摄像室	Photo Studio
不得乱刻乱画。	Do Not graffiti in toilets.
广场（珠江新城）	Square (Zhujiang New Town)
火山博物馆	Volcanic Museum
快餐	Fast Food
骨科有菌换药室	Orthopaedic Non-Sterile Dressing
总务处	General Office
微信公众号	WeChat Account
请勿倚靠	No Leaning
观堂	Taoist Temple
单位	Company
食品超市	Supermarket
天文馆	Science & Planetarium Centre
31-56	检票口 Checkin Counter No.31–56
北出口（x）	North Exit X
试衣间	Fitting Room
旅游度假区	Tourism Resort
由此上楼	Upstairs
花卉	Flowers & Plants
志愿者服务中心	Volunteer Service Center
主任室	Director’s Office
广州塔码头	Canton Tower Wharf
参谋处、绘图室	Staff Division; Drafting Office
华商报广州办事处旧址	Former Site of the Representative Office of Hwa Shiang Pao Newspaper
科学类	Science
清洁区	Clean Zone
精品腕表	Luxury Watches
中医气管炎门诊	TCM Tracheitis Clinic
手外科急诊	Emergency Hand Surgery
儿童救生衣	Life Jacket for Children
凤鸣桥	Fengming Bridge
女体检室	Physical Examination (Women)
护理部	Nursing
肾脏门诊	Nephrology Clinic
花都区政府	Huadu District Government
艺术类	Arts
仪器仪表	Instruments & Apparatuses
夹层示意图	Mezzanine Map
摄影记者区	Photo Zone
神经行为室	Neural Behavior Lab
营运证	License
东、西、南、北	East, West, South, North
精神卫生咨询室	Mental Health Counseling
序厅	Lobby
文化石	Art Stone
瞬时承载量	515 人 Maximum Visitor Capacity: 515
生活百科	Household Encyclopedia
观景长廊	Sightseeing Gallery
精品店	Boutique Shop
消防箱	Fire Hydrant
照相室	Photography Room
影城入口	ENTRANCE
少年宫	Children’s Palace
场馆服务中心	Service Centre
园	Park
非开放区域，游客止步	No Entry
婚纱摄影室	Wedding Photograph Studio
巡检	On-Site Inspection
应急检票通道/门	Emergency Check-in Lane
货运枢纽	Cargo Terminal
急诊观察室	Observation
急诊留观室	A&E Observation
棋院	Chess Institute
手信	Souvenir
青年山庄站点	Youth Villa Station
羊城通	YCT SERVICES
司法鉴定科	Judicial Authentication
表演区	Performance Area
风湿病门诊	Rheumatism Clinic
人行隧道	Pedestrian Underpass
导游服务/讲解服务	Tour Guide Service
电动游览车	Electric Sightseeing Car
专题陈列展厅	Special Exhibition Room
电脑训练治疗室	Computer Training Therapy
自动扶梯/扶梯	Escalator
航班	Schedule
古代家具	Antique Furniture
羽绒服	Down Jackets
暂停服务	Temporarily Closed
廖承志举办新闻界招待会旧址	Former Site of Liao Chengzhi’s Press Briefing
综合科	Integrated Dept.
放射介入治疗室	Interventional Radiotherapy
实验区	Experiment Area
小心防滑，上落梯注意安全	CAUTION! Slippery Steps
遗传咨询室	Genetic Counseling
职业卫生所	Occupational Disease Clinic
畜牧业	Animal Husbandry
妇幼健康教育中心	Maternal and Child Health Education Center
结算	Settlement
验光室/验光配镜室	Optometry Room
五山站	Wushan Station
注意上落安全	Watch Out Embarking/Disembarking!
咖啡店/咖啡厅	Coffee Shop/Cafe
餐饮服务部	Food & Beverages
一楼单号侧区	Stall Odd Numbers
大型活动保障中心	Events Support Center
湖滨木栈道	Lakeside Plank Path
请关闭通讯工具	Please Turn Off Cellphones
畅销书/热卖	Bestsellers
起搏室	Cardiac Pacemaker
彩妆	Cosmetics
教育处/教育中心	Education Dept./Education Center
换乘	Transfer
免费项目	Charge Free Items
创伤骨科专家门诊	Traumatic Orthopaedic Specialist Clinic
眼	B 超室 B-Ultrasound
古建筑	Historical Building
保管部	Storage Department
古旧图书	Antique Books
工程项目交易部	Construction Project Trading
南区急救分中心	South District First Aid Branch
家居	Home Furnishing
外科（普通）分诊台	Reception
工业旅游	Industrial Tourism
不得损坏公共厕所各种设施。	Use public facility with care.
心理治疗国际交流中心	Psychotherapy International Exchange Center
公共厕所前进	100 米 Toilets 100 Metres Ahead
卢慕贞故居	Former Residence of Lu Muzhen
机场	Airport
参军处	Military Advisor’s Office
硬币兑换处	Coin Change Kiosk
自行车租赁处	Bicycle Rental Service
基本陈列	Basic Display
病区药房	Inpatient Pharmacy/Inpatient Dispensary
分子遗传室	Molecular Genetics Lab
收藏	Collection
胎心监护室	Fetal Heart Rate Monitoring
矫形骨科专家门诊	Orthopaedic Specialist Clinic
（火灾）报警按钮	Fire Alarm Button
vcd	专区 VCDs
请不要将杂物抛入珠江，多谢合作	No Littering in the Pearl River
小儿骨科门诊	Pediatric Orthopaedic Clinic
数码工作室	Digital Studio
营养科	Department of Nutrition
干果	Dry Fruits/Nuts
储藏室	Storeroom
塑料	Plastics
茶台	Bar
会议室	Meeting Room/Conference Room
无障碍通道	Wheelchair Accessible
资料室	Data & File
高场	MRI High-Field MRI
服务中心	Service Center
内衣	Underwear
土地矿产交易部	Land & Mining Right Bidding
运营线路	Service Routes
调解室	Mediation Room
技术代表室	Technical Delegates
索道	Cableway
残疾人座位	Disabled Seats
腰穿室	Lumbar Puncture
请上楼参观	Please go upstairs for tour
挂号处/门诊挂号处	Registration
卖场部	Sales Dept.
中大码头	Sun Yat-sen University Wharf
体检部	Physical Examination
三防物资专用柜	Equipment Cabinet Against Nuclear, Biological & Chemical Weapon Attacks
展示	Exhibition
滑水	Surfing
眼震电图室	ENG
控制室	Control Center
社会车辆出口	Public Vehicles Exit
气管镜室	Bronchoscopy
广佛公路	Guangzhou-Foshan Highway
耳鼻喉科电测听室	Pure Tone Audiometry
治安室（派出所）	Police Office/Police Station
胸外科	Thoracic Surgery
航班及票价信息	Ticketing Information
女性泌尿外科	Female Urological Surgery
新生儿外科门诊	Neonatal Surgery Clinic
衬衫女裤	Women’s Pants & Blouses
小型车停车场	Light-duty Vehicles Parking
一楼售票厅	F1 Ticket Office
一楼乘车区	F1 Boarding Area
湖心岛	Mid-lake Island
视力筛查室	Optical Screening
骨科整复室	Orthopaedic Rehabilitation
值班室	Duty Room
机舱逃生口	Escape Hatch
一区、二区、三区	Zone 1, Zone 2, Zone 3
设计	Design
打印复印室	Copying Room
外科换药室/换药室/敷料间	Dressing Room
副部长室	Office of Deputy Head of Department
紧急时请敲击	Break Glass in Case of Emergency
进入景区	禁止吸烟 No Smoking in Scenic Area
患者入口	Patient Entrance
综合培训室	Training Room
收费标准、服务承诺	Payment Standards/Service Commitment
采摘区	Fruit-Picking Area
陈列部	Exhibition Department
干鲜果品	Dry and Fresh Fruits
一楼旅客入口	F1 Passenger Entrance
神经组阅片室	Neuroradiology
围产检测室	Perinatal Testing
肝病合并糖尿病诊室	Hepatopathy & Diabetes Mellitus Consultation
食品	Food
浴盐	Bath Salt
展厅入口	Entrance
心理健康咨询	Mental Health Counseling
电影动画	Animated Films
离心机室	Centrifuge
专家等候区	Expert Waiting Room
千足金摆件	99.9% Gold Ornaments
珠宝饰品	Jewelry & Accessories
绘画展览	Painting Exhibition
住宿区	Accommodation
申请人	Applicant
暗室	Dark Room
药物咨询	Medication Inquiry
咨询室	Counseling Room
滑沙	Sand Skiing
主廊	Main Corridor
家电、厨具采购部	Household Appliances & Kitchenware Purchase
候车室	Waiting Room
导览设施	Tour Guide Facilities
公共停车场	Public Parking
钻石项坠	Diamond Pendant
主席台	Rostrum
有毒物质	Toxic Substances
面包	Bread
美术培训室	Fine Arts Learning
新城站	New Town
新刊推荐	Recommendation for New Journals
免费停车场	Free Parking
羊绒羊毛	Cashmere & Wool
血液净化中心	Blood Purification Center
收费停车场	Paid Parking
信息科/信息办公室	Information Center/Information Office
自助服务区	Self-service
刷卡	Scan Card
大事年表	Chronology
更衣室	Locker Room
储物柜	Locker
微信支付	WeChat Pay
珠宝眼镜	Jewelry & Glasses
妇科彩超室	Gynecology Color Ultrasonography
运营保障部	Business Supporting
百货精品	Quality Goods
新城	New Town
方便食品	Instant Food
儿科肠道门诊	Pediatric Intestinal Diseases Clinic
剧毒物品	Poisonous Articles
工疗厅	Work Therapy Hall
vip	区域 VIP
儿科门诊	Pediatric Clinic
千足金戒指	99.9% Gold Ring
地下一层停车场	B1 Parking
期刊销售	Journals
婴幼儿保健咨询	Infant Healthcare Counseling
车站	Intercity Bus Terminal
景点	Scenic Spot
玻璃	Glass
医疗保险管理办公室	Medical Insurance Management
出院手续	Discharge
地铁站	Metro
艺术培训中心	Arts Training Center
记者采访区	Press Area
麻疹门诊	Measles Clinic
由此上二三楼	To F2 & F3
渡船	Ferry
登山攀岩	Mountaineering/Rock-Climbing
睡眠监测室	Sleep Monitoring
注意落叶	请勿逗留 Caution: Falling Leaves!
专业店	Specialty Store
肌肉功能检测室	Muscle Function Testing
教材及辅导资料	Textbooks & Supplementary Readings
票务室/售票处/售票口	Tickets
耳鼻咽喉科	E.N.T.
饮料罐头	Canned Beverages & Food
外交	International Relations
材料	Material Science
二楼候车厅	F2 Waiting Room
小额项目交易部	Small Projects Trading
手机维修	Cellphone Repairs
口腔颂面外科	Oral & Maxillofacial Surgery
引种场停车场	Parking of Seed Germination Farm
博物馆	Museum
经济	Economics
儿童体格生长门诊	Child Physical Growth Clinic
塔	Pagoda
急救分中心	First Aid Branch
病案整理室/病案管理办公室	Medical Records Preparation Room/Medical Records Management Office
潜水	Diving
旅客进站口	Passenger Entrance
珠江游	Pearl River Cruise
自动售票机	Ticket Vending Machine (TVM)
多导睡眠检测室	PSG Testing
古墓葬	Ancient Tomb
固定陈列	Permanent Exhibition/Permanent Display
血气室	Blood Gas Lab
避车道	Layby
加湿净化器	Humidifier
定量感觉室	QS Disorder Treatment
集控室	Central Control Room
弱电机房	Low Voltage Room
出租车调度站	Taxi Dispatch Station/Taxi Service
啤酒	Beer
桥	Bridge
火车站	Railway Station
森林公园	Forest Park
多功能厅	Multifunction Room
基础科学	Basic Science
产房	Delivery Room
托运	Consignment
内科诊区	Internal Medicine Consultation Area
动手项目/动手操作	Hands-On Activities
影视	Movies
肌电图室	EMG
烧伤病房	Burn Ward
汽车租赁营业门店	Car Rental Service
临床输血服务部	Clinical Transfusion Services
/自动提款机/自动取款机	
定额客位	500 人 Passenger Capacity: 500
山路陡滑	注意安全 Steep, Slippery! Watch Your Step!
丝织品	Silk
副调研员办公室	Associate Consultant’s Office
精神康复科	Psychiatric Rehabilitation
旁听席	Public Gallery
拔出插栓	取救生衣 Pull Out Plug and Take Life Jacket
模拟定位机治疗室	Simulated Positioner Treatment
临床心理科	Clinical Psychology
广州火车站/广州站	Guangzhou Railway Station
心理测查中心	Psychological Examination Center
孕妇营养定量检测	Gravida Nutrition Quantitative Detection
广场	Square
女子美容坊（生活馆、工作室）	Ladies’ Beauty Shop (Lounge & Studio)
残疾人客房	Accessible Guestroom
东区	East Zone
急诊手术室	A & E Operating
古迹	Historical Site
智力测查室	Intelligence Testing
外部车辆请勿进入	Registered Vehicles Only
剧场南门	South Gate
游山游水游天下	爱国爱家爱自然 Enjoy Landscape; Love Nature
影像尿流动力学检查室	Dynamic Urinary Flow Imaging Examination
女厕所	Ladies/Women
饮水净水器	Water Filter
新生儿随访门诊	Newborn Follow-Up Clinic
检票	Ticket Check
石刻	Stone Inscriptions（文字）/Stone Carving（非文字）
心理咨询室	Psychological Counseling
电机	Electrical Appliances
统计	Statistics
急诊重症监护室	Emergency ICU
广播席	Radio Commentators
绿道入口	Green Trail Entrance
电脑类	Computer
机械	Mechanics
濒危珍稀植物园	Rare and Endangered Botanical Garden
临时展览	Special Exhibition
电泳室	Electrophoresis Lab
游戏娱乐	Gaming & Entertainment
终产品质控组	Final Products QC Group
步行进站	Pedestrian Entrance
客服班	Customer Service
人力资源部	Human Resources
放射防护	Radiation Protection
核医学科	Nuclear Medicine
眼科暗室	Ophthalmic Dark Room
神经内科	Neurology
消毒与有害生物防治所	Institute for Disinfection & Vector Control
天河城广场	Teem Plaza
传记纪实	Biographies & Non-fiction Literature
查体室	Physical Examination
影碟机	DVD Player
即将开场售票处	Ticket Office for Movie Ready to Show
保护森林	依法治火
湿地公园	Wetland Park
超市连锁采购部	Chain Supermarket’s Purchase Dept.
骨科门诊	Orthopaedic Clinic
海珠区万国广场	Wanguo Plaza in Haizhu District
通讯器材	Communication Hardware
内科	Internal Medicine Dept./Internal Medicine
大元帅府码头	Generalissimo Sun Yat-sen’s Mansion Wharf
临床药学室	Clinical Pharmaceutics
急救科	Emergency Medical Dept.
心电图室	ECG
胃电图室	EGG
咪表	Parking Meter
导播室	Studio
计时控制室	Timing Control Room
人行道	Pedestrian Walkway
值班站长室	Duty Office
皮肤科专家门诊	Dermatology Specialist Clinic
火车北站	North Railway Station
诊室	1 Consultation Room 1
介入放射科	Interventional Radiography
运动员席	Athletes
转弯慢行	Slow Down! Bend Ahead
东厢	East Box
可燃垃圾	Combustible
药库	Drug Storage
瓶罐	Bottle & Can
会计司、庶务司	Accounting Office; General Office
实用类	Practicals
珠海市体育中心	Zhuhai Sports Center
药店	Pharmacy
楼梯（步行梯）	Staircase/Stairway
园广场	Park Square
科普教育	Popular Science Education
卫生用品	Hygiene Products
民族特色街	Local Ethnic Culture Street
产前宣教室	Prenatal Education
哮喘门诊	Asthma Clinic
妇女保健科	Women’s Health Care
运动员休息室	Athletes’ Lounge
称重区	Weighing Area
卫队长室	Captain of Guard’s Room
残疾人牵引车（升降平台）	Wheelchair Lift
青铜器展览	Bronzeware Exhibition
特色餐饮	Food Specialties
上落小心	Watch Your Step
大型购物中心	Shopping Mall
超声心动室	UCG
肠道传染病诊室	Enteric Infection Consultation
取号机	Please Take A Number
法学	Law
步行出站	Pedestrian Exit
请带齐您的随身物品	Please Take All Your Belongings with You
栈道	Plank Path
特色餐馆	Specialty Restaurant
公用电话	Public Telephone
肿瘤病房	Oncology Ward
门诊药房	Outpatient Pharmacy/Outpatient Dispensary
舞蹈治疗室	Dance Therapy
请勿携带托运易燃及易爆物品	Inflammable & Explosive Goods Prohibited
健康教育教室	Health Knowledge Classroom
变态反应诊室	Allergic Reaction Diagnosis
配镜区	Fitting & Prescription
外科石膏室	Surgery Plaster
观众留言簿	Complaints & Suggestions
东台	East Platform
自习室	Study Room
已喷农药，请勿靠近	Area Treated with Pesticide! Please Keep Away
配电柜	Power Distribution Cabinet
草原	Grassland
痹症科	Rheumatology
解说词	Explanation
海幢码头	Haizhuang Wharf
美术	Fine Arts
林业	Forestry
孙中山办公室	Office of Provisional President Sun Yat-sen
文化馆	Cultural Center
妇儿中心站	Women and Children’s Medical Center
广播室/演播室/播音室	Broadcasting Room
二楼双号侧区	Balcony Even Numbers
泌尿外科	Urology Surgery
中医紫癣门诊	TCM Purple Tinea Clinic
卫生监督执法队	Public Sanitation Inspection & Law Enforcement Team
婴儿用品	Baby Care Products
箱包皮具	Suitcases & Leatherware
闭馆整修	Closed for Renovation
小儿血液病中心	Pediatric Hemotology Center
评标专家抽取室	Bidding Expert Selection
售票厅	Ticket Hall/Ticket Office/Tickets
血库（面对医院发血）	Blood Bank (Distribution for Hospitals)
水疗室	Hydrotherapy
贵宾室	VIP
金银币章	Gold and Silver Coins & Badges
停车时限	Parking Time Limit
西区	West Zone
后勤区域	游客止步 Staff Only
仪器分析室	Instrumental Analysis Lab
妇科肿瘤门诊	Gynecological Oncology Clinic
疼痛门诊	Pain Clinic
肝炎科	Hepatitis
研究部	Research Department
专用车位	Reserved Parking
古树名木	Ancient Trees
三楼候车厅	F3 Waiting Room
路面清洗，小心地滑	Caution: Wet Floor
旅游运动鞋	Sneakers/Athletic Shoes
问询处/咨询台	Information
双号	Even Number
献血咨询登记处	Donation Counseling & Registration
运动用品/体育用品/体育器材	Sports Equipment
财务	Accounting
番禺市汽车客运站	Panyu Intercity Bus Terminal
一楼定额	人 Passenger Capacity on F1: xxx
新洲码头	Xingzhou Wharf
大型水滑梯/大型戏水滑道	Water Slides
多媒体教室	Multi-media
科普读物	Popular Science
献血后休息区	Donors Rest Area
禁止外出	No Exit
语言训练室	Speech Training
调味系列	Condiments & Seasonings
社教部	Public Education Department
租赁车	Car Rental Service
学生团体观众	Student Group
办证处	Library Card Application
蜡疗室	Wax Therapy
环境卫生所	Institute of Environmental Health
五指山门岗	Wuzhi Mountains Gate Guard
作业疗法室	OT
眼动检查室	Eye Tracking Examination
护肤用品	Skin Care Products
运营区/场馆工作区	BOH (Back of House)
计划财务部	Financial & Planning
evd	影片 EVD Films
糖果茶叶	Tea & Sweets
禁止通行	No Entry
购物筐	Shopping Basket
男淋浴室	Men’s Showers
手外科病房	Hand Surgery Ward
拓片	Rubbings
结核病门诊	Tuberculosis Clinic
贵宾办公室	VIP Office
居室/家居用品	Furniture & Household Items
棉麻制品	Cotton & Linen
半污染区	Semi-Contaminated Zone
老年病科	Geriatrics
免疫预防接种	Vaccination & Immunoprophylaxis
健康体检大厅	Physical Examination Hall
场地器材室	Venue Equipment Room
蓝宝石饰品	Sapphire Accessories
生殖医学中心	Reproductive Medicine Center
取阅架	Shelf Material
壁式消防栓	Wall-mounted Fire Hydrant
残障顾客专用坡道	Wheelchair Ramp
发掘	Excavation
视听测检室	Audio-Visual Testing
粮油禽蛋	Rice, Cooking Oil & Eggs
腊肉酱菜	Preserved Meat & Pickled Vegetables
工商类	Business
运动系列	Sports Series
生物反馈室	Biofeedback
院总值班室	Chief Duty Room
安全稽查部	Security Inspection Department
视野检查室	Perimetry Examination
停车车位	Parking Space
请自觉接受安检	Please Wait for Security Check
观景长廊站点	Sightseeing Gallery Station
泥沙浴	Mud and Sand Bathing
发型工作室	Hair Salon
院长办公室	President of Commission
精品区	Designer Frames
公路	Highway
预防门诊	Prevention Clinic
一立交	1 Interchange
保险柜	Home Safe & Security Boxes
西厢	West Box
电话/电脑预约窗口	Phone/Online Reservations
普通团体观众	Group Visitors
纸制文物	Paper-made Culture Heritage
眼科	A/B 超室检查室 A/B-Ultrasound
钻石耳钉	Diamond Ear Studs
疫情检查站	Quarantine Inspection
候诊观察室	Waiting & Observation
（员工）内部停车场	Staff Parking
仓库	Warehouse
康复中心办公室	Rehabilitation Center Office
中医皮肤科	TCM Dermatology
试表处	Thermometer Taking/Temperature Taking
营养食堂	Nutritious Diet Canteen
客户服务中心	Customer Service Center
游览观光车	Sightseeing Bus
北京路千年古道遗址	Ancient Site of the Beijing Lu
禁止攀爬	No Climbing
外科监护室	SICU
广州市文物总店	Guangzhou Municipal General Store of Cultural and Historical Artifacts
运动员专用通道	Athletes Only
第五仲裁庭	The 5th Court of Arbitration
泳装	Swimwear
宠物用品	Pet Supplies
西台	West Platform
锅炉房/开水间	Boiler House/Boiler Room
诗歌	Poetry
敬告乘客	Notice
机舱监控室	Monitoring Room
特价服装	Discount Clothes
花园	Garden
老年口腔病科	Geriatric Dentistry
身心医学	Psychosomatic Medicine
会展码头	Pazhou International Exhibition Centre Wharf
童袜	Children’s Socks
游客中心	Tourist Center
一街	1 Jie
女子舍宾	Women Shaping
综合组	General Service Group
呼吸睡眠障碍门诊	Respiratory & Sleep Disorder Clinic
超声胃镜检查室	EUS Exam
食府（风味食府）	Restaurant (Local Food)
献血电话咨询	Blood Donation Hotline
茶园	Tea Garden
营销策划	Marketing
停车自动收费系统	Auto Fare Collection (AFC) Parking System
紧急医疗救援指挥中心	Emergency Medical Rescue Command Center
男式手包	Men’s Bags
小儿骨科病房	Pediatric Orthopaedic Ward
口腔科消毒室	Disinfection
盆景园	Potted Landscape Garden
创伤骨科门诊	Traumatic Orthopaedic Clinic
细胞遗传室	Cytogenetics Lab
中老年女装	Senior Women’s Clothing
微型消防站	Fire Station
可回收物	Recyclable
小儿妇科门诊	Pediatrics & Gynecology Clinic
专卖店	Brand Name Store
快件提取处	Baggage Claim
小型车专用出口	Car Exit
轮椅租用处	Wheelchair Rental
会员自动售票机	Ticket Vending Machine (Members Only)
大型超市	Shopping Mall
禁止跨越	No Crossing
环保节能应用	Environmental Protection and Energy Efficiency Application
银饰品	Silver Accessories
前区	Front Section
专家门诊时间一览表	Specialist Clinic Schedule
钻石	Diamond
风景名胜区	Scenic Spot
医院	Hospital
可堆肥垃圾	Compostable
应急停车带	Emergency Pull-off Area
乘车须知	Passenger Notice
商务中心	Business Center
电视购物	TV Shopping
男士皮鞋	Men’s Leather Shoes
存包处	Baggage Locker
中药制剂室	TCM Preparation
本周排行	Weekly Best Sellers
男体检室	Physical Examination (Men)
天鹅湾	Swan Bay
中区	Central Section
接待室	Reception
汽车整车维修企业	Complete Vehicle Maintenance & Repair Services
景区	Scenic Area
捏积室	Kneading & Massage
记者休息室	Media Lounge
科研教育办公室	Research & Education
手外科专家门诊	Hand Surgery Specialist Clinic
当心落水	Do Not Fall Into Water
公共卫生监督科	Public Sanitation Oversight Section
电脑耗材	Computer Consumables
应急执法指挥中心	Emergency Law Enforcement Command Center
视频脑电室	Video-EEG
铜壶滴漏	Canton Clepsydra (Water Clock)
亚健康保健中心	Subhealth Healthcare Center
视觉电生理检查室	Optical EPS Examination
书记员	Clerk
美容院（城）	Beauty Salon
环境	Environmental Science
消防疏散示意图	Fire Evacuation Map
普通观众	General Visitors
执法二队	Law Enforcement Team 2
公园管理处	Park Administration
不可移动文物	Immovable Cultural Heritage
激光美容科	Laser Cosmetology
商场	Shopping Center
航空、航天	Aeronautics & Astronautics
骨按科	Bone Massage
平安桥	Ping’An Bridge
急救网络管理科	Networked First Aid Management
肿瘤放疗室	Oncology Radiotherapy
检验室	Testing Room
客舱	Cabin
无线电报室与电话室	Wireless Telegraph Room & Phone Room
无抽治疗室	Non-convulsive ECT Therapy
财务处/科	Finance
南区	South Zone
围产医学科	Perinatology
风湿科	Rheumatology
专家门诊	Specialist Clinic
数字特技	Digital Special Effects
广铁建设工程招标办	Bidding Office of Guangzhou Metro
中央展厅	Central Exhibition Hall
客房	Guest Room
免疫病理室	Immune-Pathological Lab
监控区域	CCTV In Operation
站	
郊游野游	Outing
白云山滑索中转站	Interchange of Baiyunshan Zipline
出站（口）	EXIT
其他工程	Other Engineering
婴儿检查室	Infant Examination
腮腺炎门诊	Mumps Clinic
地下二层停车场	B2 Parking
美食花街	Gourmet & Flowers Street
全家福摄影室	Family Portrait Photograph Studio
注意上下走桥易滑	Mind Your Step on Pontoon
儿童心理测查室	Child Psychology Counseling
儿童外借部	Book Borrowing for Children
秘书处	Secretariat
公共检索	Catalog Search
拓展区	Outdoor Exercise Area
植物园	Botanical Garden
自动直梯	Elevator/Lift
意见箱/意见簿	Suggestions & Complaints
非常紧急手柄	Emergency Handle
健身	Bodybuilding/Fitness
鸟径别墅	Bird Trail Villa
航线牌	Destination Sign
缴纳费用	Please Pay Here
植物	Botany
儿科急诊	Pediatric Emergency
胃肠室	Gastrointestinal Examination
孙中山卧室	Sun Yat-sen’s Bedroom
服务公约	Public Service Pledge
购物中心	Shopping Center
废物箱/垃圾箱	Trash
剧场东门	East Gate
请勿攀爬（坐）防护栏	No Climbing or Sitting on or over Railings
“花城花开”	Guangzhou Cultural Show
货币兑换	Currency Exchange
终点	Terminal Point
肥胖门诊	Obesity Clinic
受理	Acceptance
现场抢救区	Onsite Care
高血压门诊	Hypertension Clinic
动物园	Zoo
肿瘤外科门诊	Surgical Oncology Clinic
游船	Sightseeing Boat
珠宝钟镜	Jewelry, Clocks & Mirrors
登船	Boarding
公共厕所使用守则	Toilet Rules
网格划分简介	Grid Management System Introduction
手外科门诊	Hand Surgery Clinic
儿童筛查室	Child Screening
地下三层停车场	B3 Parking
调度室	Control Center
化学	Chemistry
层流室	Laminar Flow Room
服务监督电话	Service Complaints Hotline
不锈钢制品	Stainless Steel Products
民间工艺	Folk Arts & Crafts
书法	Calligraphy
工农业旅游示范点	Industrial and Agricultural Tourism Demonstration Site
药械科	Drug & Equipment Section
第	X 通道 Passage X
副书记办公室	Deputy Party Secretary
熟食	Cooked Food
美容美体中心（养生馆、俱乐部）	Beauty & Body Care (Health Club)
儿童口腔病科	Pediatric Dentistry
裤装、鞋区	Pants & Shoes
健康教育所	Institute of Health Education
黄埔军校码头	Whampoa Military Academy Wharf
水上漂流	Water Rafting
女淋浴室	Women’s Showers
医疗急救通道	Emergency Access
站台/公交车站台	Bus Station
特产	Specialties
音乐培训室	Music Learning
内科候诊区	Internal Medicine Waiting Area
哺乳室	Nursing Room
东门	East Gate
馆藏文物	Museum Collection
单号	Odd Number
性医学性心理诊室	Sexual Medicine & Psychology Consultation
猩红热门诊	Scarlet Fever Clinic
办理住院	Admission
疫苗室	Vaccination
会展中心码头	Exhibition Center Wharf
安检区域	Security Checkpoint
服务总台	Service Center
血液常规化验室	Routine Blood Test Lab
肛肠诊室	Anorectal Consultation
胸外科门诊	Thoracic Surgery Clinic
场馆部办公室	Venue Office
有害垃圾	Hazardous Waste
工艺品	Arts & Crafts
火情警报设施	Fire Alarm
休闲区	Leisure Area
血清库	Serum Bank
月牙湖登山道	Crescent Moon Lake Path
预防保健中心	Health Protection Center
雕塑/雕塑作品	Sculpture & Work of Art
第三仲裁庭	The 3rd Court of Arbitration
客服员	Customer Service Officer
口腔科	DR 摄片室 DR Radiography
货运堆场	Freight Yard
胃肠动力检查室	Gastrointestinal Motility Testing
饮水处	Drinking Water
南台	South Platform
方便面	Instant Noodles
一楼	Stall
斜坡地带	请勿靠近 Keep Away from Slope!
维修站	Service Station
行包托运部	Luggage Freight Department
友好林	Friendship Forest
卫士队宿舍	Security Guards’ Dorm
中医特级专家门诊	TCM Senior Specialist Clinic
团购服务中心	Group-Purchase Service Center
经颅多谱勒室	Transcranial Doppler Ultrasonography (TCD)
彩弹野战俱乐部	Paintball War Game Club
观鹿园	Deer Park
盆底康复重建外科	Pelvic Floor Recovery/Restoration Surgery
儿童游乐场/儿童乐园	Children’s Playground
食品加工机	Food Processor
第三卫生间	Unisex Toilets
南越国水关遗址	Archaeological Site of the Palace of Nanyue Kingdom (204 B.C.–112B.C.)
办公室	Office
国际划船中心	International Rowing Center
旅客服务中心	Passenger Service Center
行包安全检查	Baggage Security Check
电器城	Home Appliances Center
汽车用品	Automobile Products
建筑	Architecture
文字记者席	Press
黄金	Gold
广州市青年文化宫	Guangzhou Youth Cultural Palace
扎染治疗室	Tie-Dying Therapy
药氧治疗室	Herbal-Oxygen Treatment
电影录音	Film Recording
宿舍区	Staff Dormitories
出入口	EXIT/ENTRANCE
广州白云机场	Guanzhou Baiyun International Airport
应急电源，不对外使用	Emergency Power Only!
别墅	Villa
码头游乐中心	Pier Recreation Center
体育	Sports
服务部	Services
科学	Science
放射卫生防护所	Institute for Radiation Hygiene & Protection
生化遗传室	Biochemical Genetics Lab
特色乡村旅游点	Rural Scenic Spot
省总码头	Guangdong Provincial Federation of Trade Unions Wharf
巧克力	Chocolates
体育中心站	Sports Center Station
注意安全,小心滑倒及夹伤	Safety First! Mind Your Step!
书报亭/报刊亭	Kiosk
电视评论席	TV Commentators
广州市第二少年宫	Guangzhou Second Children’s Palace
儿童体检室	Child Physical Examination
民航驻场办	Office of Civil Aviation Authorities
急诊抢救室	Emergency
热水器	Water Heater
工作间	Office
请勿动	紧急时用 Emergency Use Only
流行服饰	Fashion
青春期教育室	Adolescent Education
财务室	Accounting
总经理办公室	General Manager
烧伤专家门诊	Burn Specialist Clinic
烟机灶具	Kitchen Ventilation & Cooking Stove
矫形骨科门诊	Orthopaedic Clinic
请您稍候	Please Wait
纸制品	Paper Products
自动报纸机	Newspaper Vending Machine
请勿把头手伸出窗外	Do Not Put Your Head or Hands Out of the Window
脂肪肝诊室	Fatty Liver Consultation
通谒室、收发室	Mail Room
无抽恢复室	Non-convulsive Recovery
医疗器械科	Medical Devices Section
剧场西门	West Gate
广州起义纪念馆	Guangzhou Uprising Memorial Hall
内科分诊处	Internal Medicine Reception
复印、取病案处	Copying & Medical Records Pickup
急救站	First Aid Station
寺	Monastery/Temple
医学美容室	Medical Cosmetology
clinic	769 骨关节病治疗中心 Osteoarthropathy Center
车库	Garage
足金项链	24K Gold Necklace
医院中心血库	Hospital Blood Bank
急诊收费	Emergency Cashier
安全保卫部	Security
庭长室	Chief Judge’s Office
洗浴中心	Bath Center
服饰美容	Fashion & Beauty
婚姻、恋爱、家庭咨询	Marriage, Love, and Family Counseling
呼吸内科（呼吸科）	Respiratory Medicine
病理诊断室	Pathological Diagnosis
循环组阅片室	Cardiovascular Radiology
童装、家居用品采购部	Children’s Wear & Household Purchase
摄影室	Photograph Studio
文学类	Literature
一楼旅客通道	F1 Passenger Exit
组织宣传部	Organization & Public Communication
男士正装/男士西装/绅士正装	Men’s Suit
副主任室	Deputy Director’s Office
养殖场	Farm
科技园区	Sci-tech Park/Science Park
民间金融街	Private Financial Street
ab	型血液告急 Group AB Blood Donors Needed
保健	Healthcare
力学	Dynamics
脱髓鞘疾病门诊	Demyelinating Diseases Clinic
美发沙龙	Hairdressing Salon
心血管外科门诊	Cardiovascular Surgery Clinic
青春期门诊	Adolescent Clinic
员工活动室	Gym
浅水区	Shallow Water
质控科	Quality Control
婴儿食品	Baby Food
二楼旅客通道	F2 Passenger Exit
中医耳鼻喉科	TCM E.N.T.
不孕症门诊	Infertility Clinic
翡翠精品	Exquisite Jade Carvings
本市观众	Local Visitors
化学危险品	Hazardous Chemical Substances
矫形器制作室	Orthotic Device Making
贵宾席	VIP
胃镜室	Gastroscopy
儿童玩具	Children’s Toys
半成品	Semi-finished Products
母婴候车室	Mother and Child Waiting Room
污染区	Contaminated Zone
公众区	Public
最大承载量	5493 人 Maximum Daily Visitor Capacity: 5,493
血液工程科	Blood Engineering
试管婴儿手术室	Test-Tube Baby Operating
西门	West Gate
应急通道，游客止步	Emergency Access Only
公共仓库	Public Warehouse
网络维护室	Network Maintenance
看台区	Audience
文胸	Bras
儿童票价	Child Price
友好广场	Friendship Square
商务休闲	Business & Leisure
cd	专区 CDs
轮渡	Ferry
古籍书店	Antiquarian Book Store
珠宝化妆休闲采购部	Jewelry & Cosmetics Purchase
保健食品	Healthy Food
早期育儿教育门诊	Early Childhood Education Clinic
口腔种植中心	Oral Implantology Center
餐厅	Dining Hall/Room
教学楼	Academic Building
评标直播厅	Hall of Live Coverage of Tender Evaluation
国际精品皮具/精品皮具	Luxury Leather Goods
鸦片战争博物馆	Opium War Museum
景点/设施维修，禁止入内	Maintenance in Progress, No Entry.
cr	摄片室 Computer Radiography (CR)
传染病控制所	Institute for Infectious Diseases Control
《大本营公报》编辑室	Editorial Office of the Official Gazette
ct	控制室 CT Control
北区急救分中心	North District First Aid Branch
旅游问询中心	Tourist Information Center
桑拿浴房	Sauna
电镜室	Electron Microscopy
外科抢救室/外科急诊室	Emergency Surgery
水利	Water Conservation
二楼	Balcony
零担货运	LTL (Less-Than-Truckload) Shipping
信息统计中心	Information Statistics Center
重症监护室/icu	ICU
枢纽东北大厅	Bus Hub Northeast Hall
玉件	Jade Products
一排、二排……二十排	Row 1, Row 2 … Row 20
书画治疗室	Painting & Calligraphy Therapy
dj	室 DJ
隔离门诊	Isolation Clinic
便民箱	Complaints & Comments Box
散文	Prose
广州市汽车客运站	Guangzhou Intercity Bus Terminal
管理	Management
五金灯具	Hardware & Lamps
织物	Textiles
dr	摄片室 Digital Radiography (DR)
安保器材	Safety Equipment
演员专用通道	Performers Only
体育保健用品	Sports & Healthcare Products
血液采集区/室	Blood Donation
中医妇科	TCM Gynecology
摄录像机	Video Camera
检录处	Call Area
亭、阁	Pavilion
图书音像	Books, Audio & Video Products
代理人	Agent
场地管理部	Site Management
烧伤急诊	Burn Emergency
餐饮广场	Food Court
主题公园	Special Theme Park
宗教	Religion
导览册	Guide Book
老幼病残孕专座	Priority Seats/Seats for Those in Need
木屋休憩区	Chalet Recreation Area
弱电竖井	Vertical Duct for Low Voltage
心理	Psychology
医用废弃物、垃圾处理站	Biohazardous Waste Disposal
老字号一条街	Time-honored Shops Street
形象设计中心	Image Design Center
电子	Electronics
救生衣放在座位下面	Life Jacket Under Seat
口腔技工室/口腔科技工室	Dental Technician Office
便利店	Convenience Store
展览厅	Exhibition Hall
外科手术室	Surgical Operating Room
鉴定诊室	1 Authentication Consultation Room 1
浴室	Shower Room
下午五点	5:00 PM/pm
管理处	Administration
刷手间	Scrub Room
投诉电话：86433246	12319 Complaint Hotline: 86433246 12319
水深危险	请勿戏水 Deep Water! No Paddling!
心脏彩超/血管超声	Color Doppler Sonography/Vascular Ultrasonography
取镜修理	Collection & Repairs Counter
儿童救生衣放在座位下面	Children’s Life Jacket Under Seat
骨科复查照相室	Orthopaedic Reexamination & Radiology
停车场	Parking Lot
无障碍电梯	Wheelchair Accessible
医疗示教室	Medical Demonstration Classroom
感染一科	Infection Dept.1/Communicable Diseases Dept.1
隔离卫生间	Isolation Toilets
歌舞厅	Dance Hall
男女鞋帽采购部	Shoes & Hats Purchase
就餐卡办理处	Meal Card Service
临床生化室	Clinical Biochemistry
大小马站书院群	Damazhan & Xiaomazhan Academy Clusters
民间收藏文物	Private Collection of Cultural Heritage
快餐厅	Snack Bar/Fast Food
医务室	Clinic
实业类	Industry & Commerce
工业	Industry
设施损坏	暂停使用 Temporarily Out of Order
整形外科门诊	Plastic Surgery Clinic
学术报告厅	Academic Hall
专题展区	Special Theme Display
平安景区	Safe Scenic Area
速冻食品	Frozen Food
书店	Bookstore
总经理室	General Manager’s Office
鞋帽精品	Designer Shoes & Hats
酒吧	Bar/Pub
名录/名人录	Directories/Who’s Who
快速检测处	Urgent Testing
应急车道	Emergency Lane
举报信箱/意见箱	Suggestions & Complaints Box
船未靠泊定，请勿上落	Please Do Not Embark or Disembark Before the Vessel Has Berthed Securely
空调机房	Air Conditioning Control Room
拍卖大厅	Auction Hall
玻璃陶瓷	Glassware & Ceramics
质量控制	Quality Control
仓储式会员店	Membership Store
不要将杂物丢入便池。	Do not litter in toilets.
等候室/候诊室/候诊厅	Waiting Room
消防中控室	Central Fire Control Room
配电箱	Power Distribution Box
ic	卡查询机 IC Card Machine
工程类	Engineering
皮肤病门诊/皮肤科普通门诊	Dermatology Clinic
大剧院	Opera House
信息产业基地	Information Technology Industry Base
房颤门诊	Atrial Fibrillation Clinic
出租汽车上下站	Taxi Stand
眼底荧光造影室	Fluorescein Eyeground Angiography
百货商场	Department Store
眼镜店	Optical Shop
千足金项坠	99.9% Gold Pendant
康复治疗室	Rehabilitation
会诊中心	Consultation Center
触摸屏	Touchscreen
艺疗厅	Art Therapy
配电室	Electricity Distribution
农家院	Farm House
立交	Interchange
超声科	Ultrasonography Dept./Ultrasonography
交车处	Car Return
图书库	Library
旺季开放时间	Opening Hours in Peak Seasons
消闲散步	Strolling
外埠观众	Non-Local Visitors
无偿献血屋	Voluntary Blood Donation Station
登船口	Boarding Gate
剧团/艺术团	Art Troupe
门票价格	Ticket Rates
开发票处	Invoice Counter
男诊室	Male Consultation Room
新品推荐/新品上架	New Arrivals
垂钓	Angling
血液研究所	Blood Research Institute
食品店	Food Store
三级文物	Class Three Cultural Heritage
微波炉	Microwave Oven
心理测量室	Psychometric Room
门诊治疗室	Outpatient Treatment
请勿攀爬栏杆	No Climbing over Railing
药疗室	Curative Treatment
文化用品/学习用具	Stationery
办公用品	Office Supplies
警卫室	Guard Room
外宾诊室	Foreign Patients
应急电话	110 报警 Call Police in Emergency: 110
儿科观察室	Pediatric Observation
工具书类	References
产后复查室	Postpartum Examination
其他图书	Miscellaneous
行包托运须知	Baggage Check Notice
软件	Software
真菌室	Mycology Lab
ld	激光视盘 Laser Discs
运动休闲	Sports & Casual Wear
人行天桥	Pedestrian Overpass
南门	South Gate
箱包	Bags & Suitcases
女更衣室	Women’s Locker Room
口腔修复科	Prosthodontics
口腔图像分析室	Image Analysis
琶洲广交会展馆	China Import and Export Fair (Pazhou) Complex
可移动文物	Movable Cultural Heritage
观众	Audience
足金手链	24K Gold Bracelet
放射科	Radiology
毛巾	Towels
副食调料	Non-staple Food & Seasonings
客轮码头	Ferry Terminal
文明旅游，从我做起	Be A Polite Visitor
历史名园	Historical Garden
社会	Sociology
行李手推车	Baggage Cart
奥林匹克体育中心	Olympic Center Stadium
羊绒毛衫	Cashmere & Wool Sweaters
医疗器械	Medical Equipment
杂粮	Miscellaneous Grains
广府学宫	Guangzhou Prefecture College
出租车	Taxi
矫形骨科病房	Orthopaedic Ward
推荐商品	Recommendations
综合执法队	Enforcement Team of Municipal Laws
物理治疗室	Physical Therapy
闭路电视监视区域	CCTV in Operation
标本室	Specimen Room
执法一队	Law Enforcement Team 1
取包处	Baggage Claim
广州市消防局旧址	Former Site of Guangzhou Municipal Fire Department
腔镜科	Endoscopy
多排	CT Multidetector CT
月牙湖	Crescent Moon Lake
译作	Translated Works
救生衣	Life Jacket
石窟寺	Grotto/Cave Temple
生殖医学门诊	Reproductive Medicine Clinic
儿童公园	Children’s Park
集体外借部	Book Borrowing for Groups
时尚皮服	Fashion Leatherwear
小卖部	Shop
电池	Battery
博物馆展厅	Museum Exhibition Hall
理发室	Barbershop
文物	Cultural Heritage
补票处	Pay Upon Arrival
蚬壳码头	xianke Wharf
太平间	Morgue
租船处	Boat Rental Service
神经内科门诊	Neurology Clinic
精液处置室	Semen Treatment
楼遗址	Tower Ruins
风机房	Ventilator Room
篮球场	Basketball Court
悬崖危险	请勿跨越 Dangerous! Stay Away!
推进机舱	Propulsion Room
中医乳肝门诊	TCM Infant Hepatitis Syndrome (IHS) Clinic
爱护展品，请勿触摸	Please Do Not Touch Exhibits
工会	Trade Union
地上（下）三层	F3/B3
激光治疗室	Laser Therapy
一楼候车厅	F1 Waiting Room
无烟景区	Smoke-Free Scenic Area
心血管内科/心内科	Internal Medicine—Cardiovasology
往一楼大厅	To F1 Hall
贸易中心	Trade Center
进口调料	Imported Sauces & Condiments
交通安全管理办公室	Traffic Safety Management
冲饮	Instant Drinks
青年山庄服务热线：13380010603	Youth Villa Service Hotline: 13380010603
网格化管理	Grid-based Management
地上（下）二层	F2/B2
口内诊室	Consultation
雕塑公园	Sculpture Park
小蛮腰	Shaping Lady
有电危险	Danger! Electrical Shock!
旅客入口	Passenger Entrance
投币	Insert Coin
2.70	元/公里 2.70 Yuan/km
医学技能培训中心	Medical Skills Training Center
豆制品	Bean Products
洗涤超市	Cleansing Products
正常开放	Open
金融博物馆	Museum of Finance
氧气站	Oxygen Station
步行街	Pedestrian Street
艺术展览	Art Exhibition
119	消防 Fire Emergency: 119
东莞市体育中心	Dongguan Sports Center
民族歌舞	Ethnic Dancing
创作室	Studio
手工艺品	Handicraft
肠道输液室	Enteric Infusion
急诊介入科/介入科诊室	A&E Intervention Clinic
旅游巴士	Tour Bus
无偿献血车	Voluntary Blood Donation Vehicle
小吃店	Snack Bar
建病例窗口	Medical Records
绿道（二期）	Green Trail (Phase II)
120	急救 First Aid Call: 120
楼下/由此下楼/下楼楼梯	Downstairs
投喂区	Feeding Area
烧伤门诊	Burn Clinic
皮服/皮衣	Leatherwear
乙型肝炎门诊	Hepatitis B Clinic
精品男鞋	Men’s Designer Shoes
母婴卫生间	Baby Changing Room
中西药品	Chinese & Western Medicine
进口图书	Imported Books
广州火车站	Guangzhou Railway Station
原有文物建筑	Original Heritage Buildings
血库	Blood Bank
手机	Cellphones
传染病	Infectious Diseases/Communicable Diseases
社区科	Community Medicine
租赁合同	Rental Contract
收费项目/有偿服务项目	Paid Service
足金耳环	24K Gold Earrings
停车场须知	Parking Notice
职业技能室	Occupational Skills Training
小客房	Guestroom
体外碎石机室	ESWL
非吸烟区	Non-Smoking Area
珠宝精品	Exquisite Jewelry
白血病门诊	Leukemia Clinic
太平桶	Fire Bucket
瓷器展览	Porcelain Exhibition
骨科封闭室	Orthopaedic Block Therapy
石制文物	Stone-made Culture Heritage
捏背室	Back Massage
文化	Culture
烧伤整形科	Burn & Plastic Surgery (Dept.)
性病科	STD
汽车客运站	Intercity Bus Terminal
地下停车场	Basement Parking
生活垃圾暂存处	Non-Biohazardous Waste
新华书店	Xinhua Bookstore
二层步行系统图	F2 Pedestrian System Plan
急诊化验室	A&E Laboratory/Lab
糖尿病门诊	Diabetes Clinic
水吧	Bar
阅览部/阅览处/阅览室	Reading Room
羊城通充值	YCT Recharge
起搏器门诊	Cardiac Pacemaker Clinic
停车处	Parking Area
前台/服务台/接待处	Reception
精品女鞋	Women’s Designer Shoes
武器库	Armory
烹饪菜谱	Cookery Books
兰花园	Orchid Garden
卫生监督/卫生监督稽查	Public Sanitation Inspection
针灸室	Acupuncture & Moxibustion
脚病治疗中心	Foot Clinic
售票窗	1-2 Ticket Counter No.1–2
推荐图书	Book Recommendation
母婴健康中心	Maternal and Infant Health Center
注意登船安全	Watch Out When Boarding
美食街	Food Street
庙	Temple
艺术品	Artwork
泌尿科	Urology
特需门诊	VIP Clinic
自动查询机	Self-Search Information
分拨中心	Allocation Center
隧道	Tunnel
陶器	Pottery
视力室	Vision Testing
保卫处	Security Dept.
加油站	Patrol Station
座	Seat
换乘大厅	Transfer Hall
广汕公路	Guangzhou-Shantou Highway
内有救生衣	Life Jacket Inside
绿色代表无人	Green Means Vacant
消防通道	Fire Engine Access
眼科手术室	Ophthalmic Operating
物理	Physics
动态血压室	ABPM
退票处	Ticket Refund
配送中心	Distribution Center
计时停车	Metered Parking/Hourly Parking
安全出口	EXIT
射击场	Shooting Range
收银台/收款台/收费处/结账/收银员	Cashier
门诊手术室	Outpatient Operating
学校卫生所	School Clinic
中医门诊	TCM Clinic
盆底康复治疗室	Pelvic Floor Rehabilitation
音像制品店	Audio Visual Shop
慢性非传染性疾病防治所	Institute for Chronic Non-Communicable Disease Prevention & Control
廊	Corridor
市立中山图书馆旧址	Former Site of Sun Yat-sen Library of Guangdong Province
乘客定额牌	Peak-passenger Capacity
小学教育	Primary School Education
请勿嬉水	地势险峻 Caution: Dangerous Terrain! No Paddling!
疏散通道	Escape Route
泌尿外科门诊	Urologic Surgery Clinic
腹组阅片室	Abdominal Radiology
老人	Elderly
政府采购交易部	Government Procurement & Trading
秦代造船遗址	Ancient Site of Shipbuilding Workshop in Qin Dynasty (221 B.C.–207B.C.)
石桥	Stone Bridge
感觉统合训练室	Sensory Integration Training
水果蔬菜	Fruits & Vegetables
部长室	Office of Head of Department
周围神经和肌肉病门诊	Peripheral Nerve & Muscle Diseases Clinic
青少年活动中心	Youth Activity Center
消化门诊	Gastroenterology Clinic
禁止停留	No Stopping
儿科诊疗室	Pediatric Treatment
展览馆/陈列馆	Exhibition Hall/Exhibition Center
东楼	East
污水处理站（点）	Sewage Disposal
口腔放射科	Radiology
读者服务处	Reader Service
厨房重地，闲人免进	Kitchen Staff Only
地下四层停车场	B4 Parking
网吧	Internet Café
换票处	Ticket-Changing Counter
体育公园	Sports Park
食杂店	Grocery Store
政府采购招标部	Government Procurement Bidding
消防栓/消火栓	Fire Hydrant
艺术博物院	Museum of Art
一楼双号侧区	Stall Even Numbers
员工通道	Staff Only
书画展览	Painting and Calligraphy Exhibition
乘客止步	Staff Only
更年期门诊	Menopause Clinic
仲裁员	Arbitrator
孕妇学校	Prenatal Classes
更多资讯请扫描左侧二维码。	Scan left QR Code for more information.
运营部	Operations Department
膀胱镜检查室	Cystoscopy
提示：你已进入录像区域	CCTV Surveillance
儿童常见病	Common Pediatric Diseases
干洗店	Laundry
儿科输液室	Pediatric Intravenous Transfusion
中医消化门诊	TCM Gastroenterology Clinic
口腔科专家门诊	Dental Specialist Clinic
洗衣机	Washing Machine
区级文物保护单位	District Level Cultural Heritage Site
狩猎区	Hunting Area
营养与食品卫生所	Institute for Nutrition & Food Hygiene
纪念品销售部/旅游纪念品商店	Souvenir Shop
美食广场	Gourmet Food Square
足金耳钉	24K Gold Ear Studs
美食城	Food Court
评估室	Evaluation
散装食品	Bulk Food Items
视野验光室	Perimetry Optometry
化学试剂	Chemical Reagents
女士休闲服装	Women’s Casual Wear
名烟名酒	Brand Cigarettes & Liquor
名品家俱	Designer Furniture
配货区	Distribution Area
策划部	Planning Department
团委	Youth League Committee
废纸回收	Paper Recycling
肛肠外科门诊	Anorectal Surgery Clinic
小型车道	Light-duty Vehicles Lane
第二仲裁庭	The 2nd Court of Arbitration
填写区	Writing Area
产科病房	Obstetric Ward
千足金手链	99.9% Gold Bracelet
茶室	Tea House
禁运物品	Prohibited Articles
配血室	Blood Matching
睡眠障碍门诊	Sleep Disorder Clinic
风味小吃	Local Delicacies
请保持地方整洁	Please Keep This Area Clean
口腔科治疗修复室	Treatment & Prosthetics
高贵女装	Women’s Designer Clothing
政治	Politics
儿童阅览室	Children’s Reading Room
大厦	Tower
经颅磁刺激治疗室	TMS Treatment
供血科	Blood Distribution
血管瘤、化疗注射室（化疗注射室）	Hemangioma & Chemotherapy Injection
候船室	Waiting Room
会员售票处	Membership Tickets
乘梯须知	Elevator Safety Instruction
爱护森林	请勿吸烟 No Smoking in Woods
（普通）分诊台/门诊接待室	Reception
旅游商品	Souvenirs & Gifts
开放时间：6:30-22:30	Opening Hours: 6:30-22:30
制剂室	Preparation
药检室	Drug Control
卫生监督执法信息中心	Public Sanitation Inspection & Law Enforcement Information Center
精品男装	Men’s Designer Clothing
口腔科正畸修复室	Orthodontics & Prosthetics
门诊病案室	Outpatient Medical Records
叶剑英商议讨逆旧址	The Historical Site of Marshal Ye Jianying Conferring on an Expedition against Warlord
白云山北门	North Gate of Baiyunshan Scenic Area
行人交通索引	Pedestrian Guide/Transit Guide
医学	Medical Science
外科病房	Surgery Ward
优惠价格	Discount Price
绿道驿站	Green Trail Station
候车厅	Waiting Hall/Waiting Lounge
病案统计科	Medical Records & Statistics
千足金项链	99.9% Gold Necklace
时刻表	Schedule/Timetable
精选超市	Premium Supermarket
一楼检票口	F1 Ticket Checkpoint
基础	Basics
动态心电图	Dynamic ECG
省际道路旅客运输站	Inter-Province Passenger Service Station
音响影院	Home Theater
男裤衬衫	Men’s Pants & Shirts
口腔科/牙科	Stomatology
妇用羊绒采购部	Women’s Cashmere Purchase
机舱重地	严禁进入 Staff Only
手工训练室	Handwork Training
免疫门诊	Immunology Clinic
快车道	Fast Lane
楼层索引	Building Directory
儿童服饰及用品	Children’s Wear and Accessories
帕金森病门诊	Parkinson’s Disease Clinic
行人绕行	Pedestrian Detour
查体中心	Regular Physical Examination Center
咨询服务中心	Information Center
故居	Former Residence
办理业务，请先取号	Please Take a Number and Wait for Your Turn
导游处	Guide Service
游泳池	Swimming Pool
油画	Oil Paintings
面包糕点	Bread & Cakes
爱护自然环境	请勿乱扔垃圾 Please Do Not Litter. Keep Our Environment Clean!
候诊区	Waiting Area
乘客请勿擅自开闸门	Please Do Not Open Gate
功能训练室	Functional Training
厨余垃圾	Kitchen Waste
服装出租处	Costume Rental Service
森林浴	Forest Spa
血液中心	Blood Supply Center
发血室	Blood Pickup
进站（口）	ENTRANCE
古文化遗址	Historical Cultural Site
电气室	Power Supply Room
口腔科门诊	Stomatology Clinic
皮肤性病科	Dermatology & STD
贸易	Trade
西楼	West
步行栈道	Footpath
幼儿教育	Preschool Education
耳鼻咽喉头颈外科	ENT & HN Surgery
人工授精手术室	Artificial Insemination Operating
硬路肩	Hard Shoulder
中药研究室	TCM Research
超车道	Overtaking Lane
总参议室	Principal Consultation Office
交通运输	Transportation
康复阅览室	Rehabilitation Reading Room
免费开放	Free Admission
多媒体视听室	Multimedia Room
探视入口	Visitor Entrance
噪音有害	CAUTION! Noise!
馆长办公室	Manager
液相色谱室	HPLC
终点站	Arrival Station
配送室	Material Distribution
男士体育服务部	Men’s Sports Product Service
新生儿门诊	Neonatal Clinic
一路	1 Lu
游憩活动分区示意图	Recreational Activities Map
猴岛	Monkey Island
预防接种室	Prophylactic Vaccination
外科（急诊）分诊处/（急诊）分诊台	Triage
农业	Agriculture
物理运动疗法室	PT
第一通道	Passway 1
舞蹈	Dance
胸组阅片室	Thoracic Radiology
一巷	1 Xiang
